{
  "width": 40,
  "height": 25,
  "tileSize": 32,
  "playerSpawn": {
    "x": 100,
    "y": 700
  },
  "zoom": 1.0,
  "camera": {
    "mode": "follow"
  },
  "pattern": {
    ".": "",
    "b": "bricks",
    "s": "spike",
    "z": {
      "type": "spike",
      "rotation": 180
    },
    "f": "flag",
    "x": "save_point"
  },
  "tiles": [
    "........................................",
    "........................................",
    "........................................",
    "........................................",
    "..........bbb............bbb............",
    "........................................",
    "..............bbb...bbb.................",
    "........................................",
    "...bbb......................bbb.........",
    "........................................",
    ".......b......x..........b..............",
    "......bbb................bbb..bbb.......",
    "........................................",
    ".....b........b........b......b.........",
    "....bbb......bbb...x..bbb....bbb........",
    "........................................",
    "...b...b....b...b......b...b............",
    "..bbb.bbb..bbb.bbb....bbb.bbb...........",
    "........................................",
    "......s........................s........",
    "........................................",
    "........zzz..................zzz........",
    "........................................",
    "bbbbbbbbbbbbbbbbbbbbbbbbbbbbbbbbbbbbbbbf",
    "bbbbbbbbbbbbbbbbbbbbbbbbbbbbbbbbbbbbbbbb"
  ]
}