{
  "width": 30,
  "height": 20,
  "tileSize": 32,
  "playerSpawn": { "x": 100, "y": 422 },
  "pattern": {
    ".": "",
    "b": "bricks",
    "x": "save_point"
  },
  "tiles": [
    "..............................",
    "..............................",
    "..............................",
    "..............................",
    "......bbb.....bbb.............",
    "..............................",
    "....bb.......bb...............",
    "..............................",
    "...b...........b....bbb.......",
    "..............................",
    "..bbb.....x...bbb.............",
    "..............................",
    "...........b..................",
    "..........bbb..............b..",
    ".........bbbbb.............b..",
    "......b....x...............b..",
    "bbbbbbbbbbbbbbbbbbbbbbbbbbbbbb",
    "bbbbbbbbbbbbbbbbbbbbbbbbbbbbbb",
    "..............................",
    ".............................."
  ]
}
