{
  "width": 60,
  "height": 30,
  "tileSize": 32,
  "playerSpawn": {
    "x": 100,
    "y": 800
  },
  "zoom": 1.0,
  "camera": {
    "mode": "follow"
  },
  "pattern": {
    ".": "",
    "b": "bricks",
    "x": "save_point"
  },
  "tiles": [
    "............................................................",
    "............................................................",
    "............................................................",
    "............................................................",
    "............................................................",
    "......bbb.....bbb...........................................",
    "............................................................",
    "....bb.......bb....bbb......................................",
    "............................................................",
    "...b...........b....b...........bbb.........................",
    "............................................................",
    "..bbb.....x...bbb..............b.b..........................",
    "............................................................",
    "...........b..................b...b.........................",
    "..........bbb..............b..bb.bb.........................",
    ".........bbbbb.............b....................b...........",
    "......b....x...............b...................b............",
    ".....bbb....................................................",
    "....bbbbb..............................bbb..................",
    "..............................bbb....bbbbb..................",
    "............................................................",
    "...............................................bbb..........",
    "............................................................",
    "......................bbb....................bbb............",
    "......................................x.....................",
    "......................bbb..............bbb..................",
    "bbbbbbbbbbbbbbbbbbbbbbbbbbbbbbbbbbbbbbbbbbbbbbbbbbbbbbbbbbbb",
    "bbbbbbbbbbbbbbbbbbbbbbbbbbbbbbbbbbbbbbbbbbbbbbbbbbbbbbbbbbbb",
    "............................................................",
    "............................................................"
  ]
}