{
    "width":60,
    "height":20,
    "tileSize":32,
    "playerSpawn":{
        "x":100,
        "y":600
    },
    "zoom":1.0,
    "camera":{
        "mode":"follow"
    },
    "pattern":{
        ".":"",
        "b":"bricks",
        "s":"spike",
        "z":{"type":"spike","rotation":180},
        "f":"flag",
        "x":"save_point"
    },
    "tiles":[
        "............................................................",
        "............................................................",
        "............................................................",
        "............................................................",
        "............................................................",
        "............................................................",
        "............................................................",
        "............................................................",
        "............................................................",
        "............................................................",
        "............................................................",
        "............................................................",
        "............................................................",
        "............................................................",
        "............................................................",
        "............................................................",
        "......z.....................................................",
        "............................................................",
        "......s.....................................................",
        "bbbbbbbbbbbbbbbbbbbbbbbbbbbbbbbbbbbbbbbbbbbbbbbbbbbbbbbbbbbb"
        
    ]

}