{
  "width": 60,
  "height": 20,
  "tileSize": 32,
  "playerSpawn": {
    "x": 100,
    "y": 600
  },
  "camera": {
    "mode": "follow"
  },
  "zoom": 1,
  "pattern": {
    ".": {
      "type": ""
    },
    "b": {
      "type": "bricks"
    },
    "f": {
      "type": "flag"
    },
    "s": {
      "type": "spike"
    },
    "test": {
      "type": "spike",
      "rotation": 180
    },
    "x": {
      "type": "save_point"
    }
  },
  "tiles": [
    "............................................................",
    "............................................................",
    "............................................................",
    "............................................................",
    "............................................................",
    "............................................................",
    "............................................................",
    "............................................................",
    "............................................................",
    ".................bbbb.......................................",
    ".................b..b.......................................",
    "................bb..b.......................................",
    ".................bbb........................................",
    ".............b..............................................",
    "................b...........................................",
    "............b...............................................",
    "......t.....................................................",
    "............................................................",
    "......s.....................................................",
    "bbbbbbbbbbbbbbbbbbbbbbbbbbbbbbbbbbbbbbbbbbbbbbbbbbbbbbbbbbbb"
  ]
}